HobbytronicsSerialTFT	KEYWORD1
HSTColour	KEYWORD1
HSTColor	KEYWORD1
HSTRotation	KEYWORD1
HSTFontSize	KEYWORD1
HSTShapeStyle	KEYWORD1

reset	KEYWORD2
begin	KEYWORD2
flush	KEYWORD2

setBackgroundColour	KEYWORD2
setBackgroundColor	KEYWORD2
setLineColour	KEYWORD2
setLineColor	KEYWORD2
setFillColour	KEYWORD2
setFillColor	KEYWORD2

setScreenRotation	KEYWORD2
setBacklightBrightness	KEYWORD2
clearScreen	KEYWORD2
drawBitmap	KEYWORD2

drawPixel	KEYWORD2
drawHorizontalLine	KEYWORD2
drawVerticalLine	KEYWORD2
drawLine	KEYWORD2
drawBox	KEYWORD2
drawCircle	KEYWORD2
drawTriangle	KEYWORD2

setFontSize	KEYWORD2
gotoTextLineStart	KEYWORD2
gotoCharacterPosition	KEYWORD2
gotoPixelPosition	KEYWORD2
write	KEYWORD2

Black	LITERAL1
Blue	LITERAL1
Red	LITERAL1
Green	LITERAL1
Cyan	LITERAL1
Magenta	LITERAL1
Yellow	LITERAL1
White	LITERAL1

PortraitInverted	LITERAL1
LandscapeInverted	LITERAL1
Portrait	LITERAL1
Landscape	LITERAL1

Small	LITERAL1
Medium	LITERAL1
Large	LITERAL1

Outline	LITERAL1
Fill	LITERAL1
FilledOutline	LITERAL1
